Why We Sleep Unlocking Dreams
Extreme Ownership
On Writing Well: The Classic Guide to Writing Nonfiction
Compound Effect - Darren Hardy
Thanks Feedback Science Receiving Well ebook
Founders at Work: Stories of Startups' Early Days
Start Small, Stay Small: A Developer's Guide to Launching a Startup
The Design of Everyday Things
Mindset: The New Psychology of Success
The Power of Habit: Why We Do What We Do in Life and Business
Why We Get Fat: And What to Do About It
How to Read a Book: The Classic Guide to Intelligent Reading (A Touchstone book)
The Lean Startup: How Today's Entrepreneurs Use Continuous Innovation to Create Radically Successful Businesses
How to Win Friends & Influence People
Think and Grow Rich
High Output Management
Pitch Anything: An Innovative Method for Presenting, Persuading, and Winning the Deal (Business Skills and Development)
Predictable Revenue: Turn Your Business Into a Sales Machine with the $100 Million Best Practices of Salesforce.com
Good to Great: Why Some Companies Make the Leap and Others Don't
The Tipping Point: How Little Things Can Make a Big Difference
The 4-Hour Workweek: Escape 9-5, Live Anywhere, and Join the New Rich
The 10X Rule: The Only Difference Between Success and Failure
The Automatic Customer: Creating a Subscription Business in Any Industry
The 48 Laws of Power
The Startup Owner's Manual: The Step-By-Step Guide for Building a Great Company
Losing My Virginity: How I Survived, Had Fun, and Made a Fortune Doing Business My Way
The 80/20 Principle: The Secret to Achieving More with Less
Hooked: How to Build Habit-Forming Products
The Chimp Paradox: The Mind Management Program to Help You Achieve Success, Confidence, and Happiness
Scaling Up: How a Few Companies Make It...and Why the Rest Don't (Rockefeller Habits 2.0)
Made to Stick: Why Some Ideas Survive and Others Die
The Snowball: Warren Buffett and the Business of Life
David and Goliath: Underdogs, Misfits, and the Art of Battling Giants
Delivering Happiness: A Path to Profits, Passion, and Purpose
The 7 Habits of Highly Effective People: Powerful Lessons in Personal Change
The Third Wave: An Entrepreneur’s Vision of the Future
Guerilla Marketing: Easy and Inexpensive Strategies for Making Big Profits from Your Small Business
The ONE Thing: The Surprisingly Simple Truth Behind Extraordinary Results
Ask: The Counterintuitive Online Method to Discover Exactly What Your Customers Want to Buy...Create a Mass of Raving Fans...and Take Any Business to the Next Level
The Marine Corps Way to Win on Wall Street: 11 Key Principles from Battlefield to Boardroom
Tools of Titans: The Tactics, Routines, and Habits of Billionaires, Icons, and World-Class Performers
The Art of Learning: An Inner Journey to Optimal Performance
Startup CEO: A Field Guide to Scaling Up Your Business, + Website
Titan: The Life of John D. Rockefeller, Sr.
The Ultimate Question 2.0 (Revised and Expanded Edition): How Net Promoter Companies Thrive in a Customer-Driven World
The $100 Startup: Reinvent the Way You Make a Living, Do What You Love, and Create a New Future
The Pyramid Principle: Logic in Writing and Thinking
The Everything Store: Jeff Bezos and the Age of Amazon
Lean In: Women, Work, and the Will to Lead
Sapiens: A Brief History of Humankind
The All-Day Energy Diet: Double Your Energy in 7 Days
The Halo Effect: . . . and the Eight Other Business Delusions That Deceive Managers
The Purpose Principles: How to Draw More Meaning into Your Life
Elon Musk: Tesla, SpaceX, and the Quest for a Fantastic Future
The Alchemist
Alibaba: The House That Jack Ma Built
The Startup Playbook: Secrets of the Fastest-Growing Startups from Their Founding Entrepreneurs
Shark Tales: How I Turned $1,000 into a Billion Dollar Business
The Science of Growth: How Facebook Beat Friendster--and How Nine Other Startups Left the Rest in the Dust
Don't Make Me Think: A Common Sense Approach to Web Usability, 2nd Edition
Traction: A Startup Guide to Getting Customers
Homo Deus: A Brief History of Tomorrow
The Complete Guide to Buying and Selling Apartment Buildings
Blink: The Power of Thinking Without Thinking
A Modern Approach to Graham and Dodd Investing
Into the Wind: My Six-Month Journey Wandering the World for Life’s Purpose
Inspired: How To Create Products Customers Love
Founders at Work: Stories of Startups' Early Days
The Art of War: Slip-case Edition
The First 20 Hours: How to Learn Anything . . . Fast!
Writing That Works; How to Communicate Effectively In Business
How Will You Measure Your Life?
Measure What Matters: OKRs: The Simple Idea that Drives 10x Growth

https://hackernewsbooks.com/top-business-books-from-interviews-with-600-founders-and-investors
